-,-,-,-,-,-,-,-,-,-,-,-,-,-,-,-,-,-,-,-
-,-,-,-,-,-,-,-,-,-,-,-,-,-,-,-,-,-,-,-
-,-,E,-,-,-,-,-,-,-,-,-,-,-,-,-,-,-,E,-
-,-,-,-,-,-,-,-,-,-,-,-,-,-,-,-,-,-,-,-
-,-,-,-,-,-,-,-,-,-,-,-,-,-,-,-,-,-,-,-
-,-,-,-,-,-,-,-,-,-,-,-,-,-,-,-,-,-,-,-
-,-,-,-,-,-,-,-,-,-,-,-,-,-,-,-,-,-,-,-
-,-,-,-,-,-,-,-,-,-,-,-,-,-,-,-,-,-,-,-
o,-,-,-,-,o,o,o,o,o,o,-,-,-,o,-,o,-,-,-
-,-,-,-,-,-,-,-,-,-,-,-,X,-,-,-,-,-,-,-
-,-,-,-,-,-,-,-,-,-,-,-,-,-,-,-,-,-,-,-
-,-,-,-,-,-,-,-,-,-,-,-,-,-,-,-,-,-,-,-
-,-,X,X,-,-,-,-,-,-,-,-,-,-,-,-,-,-,X,X
X,X,X,X,X,X,-,X,-,X,X,X,-,X,X,X,X,X,X,X
